XXXXXXXXXXXXXXXXXXXXXXXXXXXXXXXXXXXXX
X----------------------------------X
X----O-------C--------C------------X
X-------------------------------XXXX
X-----------------C----------------X
X----------------------------------X
X--------------------------------O-X
X----------------------------------X
XX------C---------C--------------XXX
XX-------------O-----C-------------X
XXXXXXXXXXXXXXXXXXXXXXXXXXXXXXXXXXXXX